11111111
1P000001
10000001
100C0001
100000E1
11111111
