11111 1111
1P001 1PC1
10C01 10E1
100E1 1111
11111
