11111
1P001
10C01
100E1
11111

1111
1PC1
10E1
1111
