11111111111
1C00P100001
10000000001
11110000001
1000C000C01
1EC00000001
11111111111
